1111111111
1000000001
10P0000CE1
1111111111
