11111111
10E00001
10000C01
1P000001
11111111
