111111111
1P10CE111
100000001
101000001
111111111
