11111111
10E10101
10010C01
1P000001
11111111
